### ####
#     ##
# ######
# ##   #
#    # #
###### #
##     #
### ####
