### ####
### ####
### ####
###   ##
##### ##
##### ##
###   ##
### ####
